_____n_____TS
TTTSB_BTSSTTT
_K__TBT____SS
____SBT__M___
<__>T_T__+___
_>__SMS_-_+__
___<T_S______
BSSTS_TSS_TBB
_________B___
____V_______M