___n_________
TTTS___TSSTBS
____TBT____K_
__M_SBB______
<__>T_T__+___
_>__B_S_-_+__
___<T_S_____S
BBBTS_TSS_TST
_V___M___B_BB