_____H______
SSS_S_SSSS__
B___SBS__S__
____SBSn_S__
_B__SSS_KS__
____P____S__
_TBT_____S__
_TTT__+-_B__
_________B__
BSSSSBBSSSB_
_______M____
___<___>_S__
